Grapheme	IPA
a	a
A	a
ä	ə
ae	a j
au	a w
b	b
d	d
dd	ɖᶼ
e	e
g	ɡ
i	i
ɨ	ɪ
k	k
l	l
ll	ɽ
m	m
n	n
ng	ŋ
ny	ɲ
o	o
oe	o j
p	p
r	r
s	s
t	t
tt	ʈᶳ
u	u
ui	w i
w	w
y	j
z	z
